[1,5,5,5,5,5,5,5,1,1,1,1,1,1,4,1,1,1,1,13,13,13,13,1,1],
[5,0,0,0,0,0,0,0,2,0,0,1,6,0,0,0,6,1,0,0,0,0,0,0,1],
[5,0,2,0,0,0,2,0,5,1,0,1,6,0,0,0,6,1,0,0,0,0,0,0,1],
[5,0,0,0,0,0,0,0,5,1,0,1,6,0,0,0,6,1,0,0,1,1,0,0,1],
[5,0,0,0,2,0,0,0,5,1,0,1,6,0,0,0,6,1,0,0,1,5,0,0,1],
[5,0,0,0,0,0,0,0,5,1,0,1,6,0,0,0,6,1,0,0,1,5,0,0,1],
[5,0,2,0,0,0,2,0,5,1,0,1,1,0,0,0,1,1,0,0,1,5,0,0,1],
[5,0,0,0,0,0,0,0,5,1,0,0,0,0,0,0,5,1,0,0,1,5,0,0,1],
[1,5,5,5,0,5,5,5,1,1,1,1,1,1,1,1,1,1,0,0,1,5,0,0,1],
[1,1,1,1,0,1,1,1,1,1,1,1,0,0,1,1,1,1,0,0,1,5,0,0,1],
[1,0,0,0,0,0,0,0,1,1,1,1,0,0,0,1,1,1,0,0,1,5,0,0,1],
[1,0,0,0,0,0,0,0,1,0,0,1,0,0,0,0,1,1,0,0,1,5,0,0,1],
[1,0,0,0,0,0,0,0,1,0,0,10,0,0,0,0,2,0,0,0,1,5,0,0,1],
[1,0,0,0,0,0,0,0,1,0,0,1,0,0,0,0,1,1,1,1,1,1,0,0,1],
[1,0,0,0,0,0,0,0,1,1,1,1,0,0,0,1,0,0,2,0,0,1,10,10,1],
[1,0,0,0,0,0,0,0,1,1,1,1,0,0,1,1,1,1,6,0,0,0,0,0,1],
[1,2,2,1,1,1,1,1,1,1,1,1,1,1,5,5,5,5,1,0,0,0,0,0,1],
[1,0,0,0,0,1,1,0,0,0,0,0,0,1,0,0,0,0,1,0,0,6,0,0,6],
[1,1,1,1,0,0,1,0,6,0,0,6,0,1,0,0,0,0,1,1,1,1,1,10,1],
[1,0,0,1,1,2,1,0,0,0,0,0,0,1,0,0,0,0,1,0,0,0,0,0,1],
[1,1,0,0,0,0,10,0,0,0,0,0,0,10,0,0,0,0,1,0,0,0,0,0,1],
[1,0,1,2,1,0,1,0,0,0,0,0,0,1,0,0,0,0,10,0,0,13,0,0,1],
[1,0,0,0,1,0,1,0,6,0,0,6,0,1,0,0,0,0,1,0,0,0,0,0,1],
[1,0,1,0,1,0,1,0,0,0,0,0,0,1,0,0,0,0,1,0,0,0,0,0,1],
[1,1,1,1,1,1,1,1,1,1,1,1,1,1,5,5,5,5,1,1,1,1,1,1,1],
