[1,1,1,1,6,6,6,1,1,1,1,1,1,1,1,1],
[1,0,1,0,0,0,0,0,0,0,0,0,0,0,0,5],
[1,0,1,1,1,1,1,7,1,1,1,1,0,0,0,1],
[1,0,0,0,0,0,0,0,1,0,0,6,1,7,1,1],
[1,0,0,0,0,0,0,0,5,1,0,1,0,0,0,1],
[1,0,0,0,0,0,0,0,1,6,0,1,0,0,0,1],
[1,1,1,1,1,1,1,1,1,1,8,1,0,0,0,1],
[1,0,1,0,0,0,0,0,0,1,0,0,0,0,0,1],
[5,0,0,0,0,0,0,0,0,7,0,0,0,0,0,1],
[1,0,0,0,0,0,1,0,0,1,0,0,0,1,1,1],
[1,0,0,0,0,0,1,1,1,1,1,1,1,5,5,1],
[1,0,0,0,0,1,1,0,0,0,0,0,0,0,0,1],
[1,0,0,0,1,6,1,0,0,0,1,0,0,0,0,1],
[1,0,0,0,0,0,7,0,0,1,5,0,0,0,0,1],
[1,0,0,0,0,0,7,0,0,1,5,0,0,0,4,1],
[1,1,1,1,1,6,1,1,1,1,1,1,1,1,1,1],
