[1,1,1,1,1,1,1,1,1,1,1,1,1,1,1,1,1,1,1,1,1,4,1,1],
[1,0,0,0,0,0,0,0,0,0,0,0,0,0,0,0,0,0,0,1,0,0,0,1],
[1,0,0,0,0,0,0,0,0,0,0,0,0,0,0,0,0,0,0,1,0,0,0,1],
[1,0,0,1,2,1,1,1,1,1,1,1,1,1,1,10,10,10,1,5,0,0,0,5],
[6,0,0,6,0,1,0,0,0,0,0,0,0,1,0,0,0,0,0,1,0,0,0,1],
[1,0,0,1,0,5,0,0,0,0,0,0,0,1,0,0,0,0,0,1,0,0,0,1],
[1,0,0,1,0,1,0,0,0,0,0,0,0,1,0,0,0,0,0,1,0,0,0,1],
[1,0,0,1,0,1,0,0,0,0,0,0,0,1,0,0,0,0,0,1,0,0,0,1],
[1,0,0,1,0,5,0,0,0,0,0,0,0,1,0,0,0,0,0,1,0,0,0,1],
[1,0,0,1,0,1,0,0,0,0,0,0,0,1,0,0,0,0,0,1,0,0,0,1],
[1,0,0,1,0,1,1,10,1,1,1,10,10,1,0,0,0,0,0,1,0,0,0,1],
[1,0,0,1,0,1,0,0,0,1,1,0,0,1,0,0,0,0,0,1,0,0,0,1],
[1,0,0,1,0,1,0,0,0,1,1,0,0,1,0,0,0,0,0,1,0,0,0,1],
[1,0,0,1,0,1,0,0,0,1,1,0,0,1,0,0,0,0,0,1,0,0,0,1],
[1,0,0,1,0,1,0,0,0,1,1,1,1,1,2,1,1,1,1,5,0,0,0,5],
[1,0,0,1,0,1,0,0,0,5,1,1,1,1,0,0,0,0,0,1,0,0,0,1],
[1,0,0,1,0,1,0,0,0,5,1,1,1,1,0,0,0,0,0,1,0,0,0,1],
[1,0,0,1,0,1,0,0,0,1,1,1,1,1,0,0,1,0,0,1,0,0,0,1],
[1,0,0,1,0,1,0,0,0,1,6,6,6,1,0,0,0,0,0,1,0,0,0,1],
[6,0,0,6,0,1,0,0,0,0,0,0,0,0,0,0,0,0,0,1,0,0,0,1],
[1,0,0,1,2,1,1,1,1,1,1,1,1,1,1,1,1,1,1,1,2,2,2,1],
[1,0,0,0,0,0,0,0,0,0,0,0,0,0,0,0,0,0,0,0,0,0,0,5],
[1,0,0,0,0,0,0,0,0,0,0,0,0,0,0,0,0,0,0,0,0,0,0,5],
[1,1,1,1,1,1,1,1,1,1,1,1,1,1,1,1,1,1,1,1,1,1,1,1],
