[1,1,1,1,1,1,1,1,1,1, 1, 1, 1, 1, 1, 1],
[1,0,1,0,0,0,0,0,0,0, 0, 0, 0, 0, 0, 5],
[1,0,1,10,1,1,1,1,1,1, 1, 1, 0, 0, 0, 1],
[1,0,0,0,0,0,0,0,1, 0, 0, 6, 1, 10, 1, 1],
[1,0,0,0,0,0,0,0,5, 1, 0, 1, 0, 0, 0, 1],
[1,0,0,0,0,0,0,0,1, 6, 0, 1, 0, 0, 0, 1],
[1,1,1,1,1,1,1,1,1, 1, 9, 1, 0, 0, 0, 1],
[1,0,1,0,0,0,0,0,0, 1, 0, 0, 0, 0, 0, 1],
[5,0,0,0,0,0,0,0,0, 10, 0, 0, 0, 0, 0, 1],
[1,0,0,0,0,0,1,1,1, 1, 0, 0, 0, 1, 1, 1],
[1,0,0,0,0,1,1,6,1, 1, 1, 1, 1, 1, 1, 1],
[1,0,0,0,0,1,1,0,0, 0, 0, 0, 0, 0, 0, 5],
[1,0,0,0,1,6,1,0,1, 1, 1, 1, 1, 1, 0, 1],
[1,0,0,0,0,0,10,0,1, 0, 0, 0, 0, 1, 0, 1],
[1,0,0,0,0,0,10,0,9, 0, 0, 0, 0, 1, 4, 1],
[1,1,1,1,1,6,1,5,1, 1, 1, 1, 1, 1, 1, 1],
