[1,1,1,6,6,1,1,1,1,1,1,1,1,1,1,1,1,1,1,1,1,1,1,1],
[1,0,0,0,0,0,10,0,0,0,0,0,1,0,0,0,0,0,0,0,0,0,0,5],
[1,0,0,0,0,0,10,0,0,0,0,0,1,0,0,0,0,0,0,0,0,0,0,5],
[1,1,1,6,6,1,1,1,1,0,0,0,1,0,0,0,0,0,1,1,10,10,1,1],
[1,1,1,1,1,5,5,1,0,0,0,0,1,0,0,0,0,0,1,0,0,0,0,1],
[1,0,0,0,0,0,0,1,0,0,0,1,1,0,0,0,0,0,1,0,0,0,0,1],
[1,0,0,0,0,0,0,1,0,0,0,0,1,0,0,0,0,0,1,0,0,0,0,1],
[1,0,0,0,0,0,0,1,1,0,0,0,1,0,0,0,0,0,1,0,0,0,0,1],
[1,0,0,13,13,0,0,1,0,0,0,0,1,0,0,0,0,0,1,0,0,0,0,1],
[1,0,0,13,13,0,0,1,0,0,0,1,1,0,0,0,0,0,1,0,0,0,0,1],
[1,0,0,1,1,0,0,1,0,0,0,0,1,0,0,0,0,0,1,0,0,0,0,1],
[1,0,0,1,1,0,0,1,1,0,0,0,1,1,1,10,1,1,1,1,10,10,1,1],
[1,0,0,1,1,0,0,1,0,0,0,0,1,0,0,0,0,0,1,0,0,0,0,1],
[1,0,0,1,1,0,0,1,0,0,0,1,1,0,0,0,0,0,1,0,0,0,0,1],
[1,0,0,1,1,0,0,1,0,0,0,0,1,0,0,0,0,0,1,0,0,0,0,1],
[6,0,0,1,1,0,0,1,1,0,0,0,1,0,0,0,0,0,1,0,0,0,0,1],
[6,0,0,1,1,0,0,1,0,0,0,0,1,0,0,0,0,0,1,0,0,0,0,1],
[1,0,0,1,1,0,0,1,0,0,0,1,1,0,0,0,0,0,1,0,0,0,0,1],
[1,0,0,1,1,0,0,1,0,0,0,0,10,0,0,0,0,0,1,0,0,0,0,1],
[6,0,0,1,1,0,0,1,1,0,0,1,1,0,0,0,0,0,1,0,0,0,0,1],
[6,0,0,1,1,0,0,1,6,0,0,6,1,0,0,0,0,0,1,0,0,0,0,1],
[6,0,0,1,1,0,0,1,1,5,5,1,1,1,1,1,1,1,1,0,0,0,0,1],
[1,0,0,1,1,0,0,0,0,0,0,0,0,0,0,0,0,0,0,0,0,0,0,1],
[1,1,1,1,1,1,1,6,6,6,6,6,6,6,6,6,6,6,6,1,5,5,1,1],
