[1,4,1,1,1,1,1,1],
[1,0,0,0,0,0,0,1],
[1,0,0,0,0,0,0,1],
[1,0,0,0,0,0,0,1],
[1,0,0,0,0,0,0,1],
[1,0,0,0,0,0,0,1],
[1,0,0,0,0,0,0,1],
[1,5,6,7,8,9,1,1],
